^ ^ ^ ^ ^ ^ ^ # # # # # # # # @
^ ^ ^ ^ ^ ^ # # # # # # # # # @
^ ^ ^ ^ ^ # # # # # # # # # @ @
^ ^ ^ ^ ^ # # # # # # # @ @ @ @
^ ^ ^ @ @ @ @ @ # # # @ @ @ @ @
@ @ @ @ @ @ @ @ @ @ @ @ @ @ @ @
@ @ @ @ . . . . . + - - - - - -
@ @ @ @ @ . . . . | @ @ @ @ @ @
@ @ @ @ @ @ . . . | @ @ @ @ @ @
- - - - - - - - - + @ @ @ @ @ @
@ @ @ @ @ @ @ @ @ | @ . @ @ @ @
@ @ @ . @ @ @ @ @ | @ . . . % %
@ @ % . . % % % % | % % . . . %
@ % % . . . % % % | % % . . . .
% % % % % % % % % | % % % . . %
% % % % % % % % % | % % % % % %
